WWWWW.WWW.WE
WW........W.
...W.W.WW.W.
.WWW.W.WW.W.
.W.W.WWW....
...W...W.W..
WWWW.W.WWWW.
S...........