W..........E
W.WWWWWWWWW.
W.W.......W.
W.W.WWWWW.W.
W...W.....W.
WWW.W.WWWWW.
S...W.......