WWWWWWWWWWWWWWWWWWWWWWWWWWWWWWWWWWWWWWWWWWWWWWWWWWWWWWWWWWWWWWWWWWWWWWWWWWWWWW
W111111111111-------------------------------------------------------------111W
W112223333331-11223333222333444555666665554443333332222222111111111222222--11W
W122233444432-224434443334455566667777766665655555444443333322242343333332-22W
W133433444433-334445554334445566778888888777776666555544444333222223333333S22W
W123333444433-334455554445566788889999988877776666554433333322221112222333321W
W122333344333-334455554455667888889999999888777666555443332222211112223333321W
W122222222222-222233344556677788888899988877766655555443333322223333222222111W
W11212211212--222233344445555667777888887777666655554443333222211211211212111W
W11111111111-2222223333444455556666666666666555555544444443333322221111111111W
W12223334444-4443333222233344455555555555555544555555555333333322222111111111W
W22233445555-6655544433344444445555555556666666777888777666665555444433222111W
W22233445555-6655544444444444445555555556666666777888777666665555444433222111W
W23334555667-9999955555555566666666666677777777888888888888888777777676655555W
W44446677777-9999999997777778888888999999999999999999999999999999999888888777W
W44556778888-9999999997777778888888999999999999999999999999999999999888888777W
W45667778889-9999999999777777888888899999999999999999999999999999999988888877W
W33333556667-E777777777777777766666666777777777777777777777777777777777777777W
W3333355666666677777777777777766666666666666666667777777777777777777777777777W
W1222224444455555566666666555555555555555555555555555666666666666555555555555W
W1111133333333344444445555554444444444444444443333444455555555555554444443333W
W1111111111222222333333444333333333333333333333333333333344444444333333333333W
W1111111111111111112222222222222222221111111111111111122222222222211111111111W
WWWWWWWWWWWWWWWWWWWWWWWWWWWWWWWWWWWWWWWWWWWWWWWWWWWWWWWWWWWWWWWWWWWWWWWWWWWWWW
